##########
#   #    #
# #   ## #
#  ##### #
## ##    #
#   ### ##
# #   #  #
### # ## #
#   #    #
##########